Austin==/:/==Epic-2==/:/==An epic level==/:/==
...r........r...
.o.r........r.o.
...r........r...
o..r........r..o
..or........ro..
...r.p....p.r...
.o.rp..yy..pr.o.
...r..y..y..r...
o..r.y....y.r..o
..ory......yro..
................
................
................
................
................
................
................
................
................
................
