Austin==/:/==Epic-1==/:/==An epic level==/:/==
.............yyy
................
...yyy..........
.........rrr....
................
ooo.............
............ooo.
....rrr.........
................
................
yyy.....yyy.....
................
...........rrr..
.....ooo........
................
................
................
................
................
................
